"filename", "language", "XML", "Java", "Java Properties", "Batch", "comment", "blank", "total"
"/Users/krishanukashyap/Documents/ExpenseManager/.mvn/wrapper/maven-wrapper.properties", "Java Properties", 0, 0, 2, 0, 0, 1, 3
"/Users/krishanukashyap/Documents/ExpenseManager/mvnw.cmd", "Batch", 0, 0, 0, 102, 51, 36, 189
"/Users/krishanukashyap/Documents/ExpenseManager/pom.xml", "XML", 66, 0, 0, 0, 0, 4, 70
"/Users/krishanukashyap/Documents/ExpenseManager/src/main/java/com/ltp/expense_manager/ExpenseManagerApplication.java", "Java", 0, 9, 0, 0, 0, 5, 14
"/Users/krishanukashyap/Documents/ExpenseManager/src/main/java/com/ltp/expense_manager/GlobalExceptionHandler.java", "Java", 0, 37, 0, 0, 3, 7, 47
"/Users/krishanukashyap/Documents/ExpenseManager/src/main/java/com/ltp/expense_manager/entity/Expense.java", "Java", 0, 59, 0, 0, 0, 17, 76
"/Users/krishanukashyap/Documents/ExpenseManager/src/main/java/com/ltp/expense_manager/entity/Person.java", "Java", 0, 41, 0, 0, 0, 9, 50
"/Users/krishanukashyap/Documents/ExpenseManager/src/main/java/com/ltp/expense_manager/exception/ErrorResponse.java", "Java", 0, 25, 0, 0, 0, 11, 36
"/Users/krishanukashyap/Documents/ExpenseManager/src/main/java/com/ltp/expense_manager/exception/ExpenseNotFoundException.java", "Java", 0, 6, 0, 0, 0, 3, 9
"/Users/krishanukashyap/Documents/ExpenseManager/src/main/java/com/ltp/expense_manager/exception/PersonNotFoundException.java", "Java", 0, 6, 0, 0, 0, 2, 8
"/Users/krishanukashyap/Documents/ExpenseManager/src/main/java/com/ltp/expense_manager/repository/ExpenseRepository.java", "Java", 0, 5, 0, 0, 0, 5, 10
"/Users/krishanukashyap/Documents/ExpenseManager/src/main/java/com/ltp/expense_manager/repository/PersonRepository.java", "Java", 0, 5, 0, 0, 0, 5, 10
"/Users/krishanukashyap/Documents/ExpenseManager/src/main/java/com/ltp/expense_manager/service/ExpenseService.java", "Java", 0, 10, 0, 0, 0, 9, 19
"/Users/krishanukashyap/Documents/ExpenseManager/src/main/java/com/ltp/expense_manager/service/ExpenseServiceImpl.java", "Java", 0, 40, 0, 0, 0, 13, 53
"/Users/krishanukashyap/Documents/ExpenseManager/src/main/java/com/ltp/expense_manager/service/PersonService.java", "Java", 0, 8, 0, 0, 0, 1, 9
"/Users/krishanukashyap/Documents/ExpenseManager/src/main/java/com/ltp/expense_manager/service/PersonServiceImpl.java", "Java", 0, 38, 0, 0, 2, 8, 48
"/Users/krishanukashyap/Documents/ExpenseManager/src/main/java/com/ltp/expense_manager/validation/Age.java", "Java", 0, 15, 0, 0, 0, 6, 21
"/Users/krishanukashyap/Documents/ExpenseManager/src/main/java/com/ltp/expense_manager/validation/AgeValidator.java", "Java", 0, 14, 0, 0, 0, 5, 19
"/Users/krishanukashyap/Documents/ExpenseManager/src/main/java/com/ltp/expense_manager/validation/Email.java", "Java", 0, 15, 0, 0, 0, 6, 21
"/Users/krishanukashyap/Documents/ExpenseManager/src/main/java/com/ltp/expense_manager/validation/EmailValidator.java", "Java", 0, 17, 0, 0, 0, 7, 24
"/Users/krishanukashyap/Documents/ExpenseManager/src/main/java/com/ltp/expense_manager/web/ExpenseController.java", "Java", 0, 45, 0, 0, 0, 17, 62
"/Users/krishanukashyap/Documents/ExpenseManager/src/main/java/com/ltp/expense_manager/web/PersonController.java", "Java", 0, 40, 0, 0, 0, 9, 49
"/Users/krishanukashyap/Documents/ExpenseManager/src/main/resources/application.properties", "Java Properties", 0, 0, 3, 0, 0, 0, 3
"/Users/krishanukashyap/Documents/ExpenseManager/src/test/java/com/ltp/expense_manager/ExpenseManagerApplicationTests.java", "Java", 0, 9, 0, 0, 0, 5, 14
"Total", "-", 66, 444, 5, 102, 56, 191, 864